3 12 33
#################################
# *p                *           #
# * #  *# # #*#*#*# #*#*#*#*#   #
# * *  * ****  *      *   * *   #
# # # # # #*# #*#*#*#*# # # #*  #
# * *      x **  *  *           #
# # # # # # # # # #*# #*# # #   #
#  *   s   *  *      *   5      #
# # # # #*# # #*#*#*# # # # #   #
#     **  *       *             #
# #*# # # # # # #*#4# # # # #   #
#################################

