1 9 13
#############
#o # p  ** *#
# #####*# # #
# * *     * #
# # # # # # #
# *       # #
# ######### #
#           #
#############